"","Date_reported","Country_code","Country","WHO_region","New_cases","Cumulative_cases","New_deaths","Cumulative_deaths","stay_home_requirements","New_infectious","lag_infectious","stay_home_diff_07","stay_home_diff_05","stay_home_diff_03","lag_stay_home","lag_stay_home_diff_07","lag_stay_home_diff_05","lag_stay_home_diff_03","lag_stay_home_diff_01","New_infec_07ma","lag_infec_07ma","New_infec_05ma","lag_infec_05ma","New_infec_03ma","lag_infec_03ma","delta_infectious","delta_infec_07ma","delta_infec_05ma","delta_infec_03ma"
"1",2020-10-01,"FR","France","Europe",11889,538294,56,31746,"0",-845,80158,"0","0","0","0","0","0","0","0",-823.142857142857,79254.4285714286,-1668.2,79075,-1365.33333333333,79736.6666666667,-1.05416801816413,-1.03860802731168,-2.10964274423016,-1.71230299736633
"2",2020-10-02,"FR","France","Europe",13959,552253,62,31808,"0",-2109,78049,"0","0","0","0","0","0","0","0",-556.285714285714,78698.1428571429,-1020,78055,-2327.66666666667,77409,-2.70214865020692,-0.706860027555561,-1.30677086669656,-3.00697162689954
"3",2020-10-03,"FR","France","Europe",11543,563796,118,31926,"0",-4029,74020,"0","0","0","0","0","0","0","0",-386.571428571429,78311.5714285714,-507.2,77547.8,-1037.66666666667,76371.3333333333,-5.4431234801405,-0.493632577561061,-0.654048212844207,-1.35871225678047
"4",2020-10-04,"FR","France","Europe",16911,580707,43,31969,"0",3025,77045,"0","0","0","0","0","0","0","0",161.857142857143,78473.4285714286,-143.8,77404,139.333333333333,76510.6666666667,3.92627685119086,0.20625725905402,-0.18577851273836,0.182109684052768
"5",2020-10-05,"FR","France","Europe",12545,593252,32,32001,"0",1422,78467,"0","0","0","0","0","0","0","0",1145.85714285714,79619.2857142857,817.4,78221.4,1806.33333333333,78317,1.81222679597793,1.43917033740928,1.04498257510093,2.30643836374393
"6",2020-10-06,"FR","France","Europe",4813,598065,68,32069,"0",972,79439,"0","0","0","0","0","0","0","0",2039.28571428571,81658.5714285714,2831.8,81053.2,1697,80014,1.22358035725525,2.49733209705918,3.49375471912275,2.12087884620191
"7",2020-10-07,"FR","France","Europe",10476,608541,65,32134,"0",2697,82136,"0","0","0","0","0","0","0","0",3840.14285714286,85498.7142857143,3055.8,84109,3237.33333333333,83251.3333333333,3.28357845524496,4.49146269534546,3.63314270767694,3.88862640838585
"8",2020-10-08,"FR","France","Europe",17932,626473,77,32211,"0",6043,88179,"0","0","0","0","0","0","0","0",4802.85714285714,90301.5714285714,4486.8,88595.8,4295,87546.3333333333,6.85310561471552,5.31868611683707,5.0643484228372,4.905973598742
"9",2020-10-09,"FR","France","Europe",18104,644577,76,32287,"0",4145,92324,"0","0","0","0","0","0","0","0",5107.71428571429,95409.2857142857,6245.2,94841,6255,93801.3333333333,4.48962349984836,5.35347712486805,6.58491580645501,6.66834870861821
"10",2020-10-10,"FR","France","Europe",20120,664697,90,32377,"0",8577,100901,"0","0","0","0","0","0","0","0",5466.28571428571,100875.571428571,6417,101258,7495.33333333333,101296.666666667,8.50041129423891,5.41883990035815,6.33727705465247,7.39938793642436
"11",2020-10-11,"FR","France","Europe",26675,691372,54,32431,"0",9764,110665,"0","0","0","0","0","0","0","0",5438.85714285714,106314.428571429,5904.8,107162.8,7299,108595.666666667,8.8230244431392,5.11582220394759,5.51012104946866,6.72126266548389
"12",2020-10-12,"FR","France","Europe",16101,707473,46,32477,"0",3556,114221,"0","0","0","0","0","0","0","0",5113.28571428571,111427.714285714,5576.8,112739.6,5600.66666666667,114196.333333333,3.11326288510869,4.58888145293425,4.94662035345167,4.90441899769111
"13",2020-10-13,"FR","France","Europe",8295,715768,94,32571,"0",3482,117703,"0","0","0","0","0","0","0","0",6299.57142857143,117727.285714286,4614.2,117353.8,3181,117377.333333333,2.95829333152086,5.35098672355359,3.93187097477883,2.71006327172765
"14",2020-10-14,"FR","France","Europe",12981,728749,108,32679,"0",2505,120208,"0","0","0","0","0","0","0","0",5732,123459.285714286,5151.2,122505,3250.33333333333,120627.666666667,2.08388792759217,4.64282614858571,4.20488959634301,2.69451728873697
"15",2020-10-15,"FR","France","Europe",21696,750445,101,32780,"0",3764,123972,"0","0","0","0","0","0","0","0",5158.85714285714,128618.142857143,5360.8,127865.8,6239.33333333333,126867,3.03616945761946,4.0109871191245,4.19252059581217,4.9180112506273
"16",2020-10-16,"FR","France","Europe",30553,780998,88,32868,"0",12449,136421,"0","0","0","0","0","0","0","0",6612.57142857143,135230.714285714,5814.8,133680.6,6939,133806,9.12542790332867,4.88984434009603,4.34977102137483,5.18586610465898
"17",2020-10-17,"FR","France","Europe",24724,805722,162,33030,"2",4604,141025,"2","2","2","0","0","0","0","0",6779.28571428571,142010,8060.2,141740.8,7601.66666666667,141407.666666667,3.26466938486084,4.77380868550505,5.68657718878403,5.3757104164555
"18",2020-10-18,"FR","France","Europe",32427,838149,89,33119,"2",5752,146777,"2","2","2","0","0","0","0","0",7484.71428571429,149494.714285714,8237.2,149978,8029.33333333333,149437,3.91887012270315,5.00667486571432,5.49227219992266,5.37305575816788
"19",2020-10-19,"FR","France","Europe",29833,867982,85,33204,"2",13732,160509,"2","2","2","0","0","0","0","0",7536.14285714286,157030.857142857,7236,157214,8044.33333333333,157481.333333333,8.55528350435178,4.79914775621898,4.60264353047438,5.10811863416617
"20",2020-10-20,"FR","France","Europe",12944,880926,146,33350,"2",4649,165158,"2","2","0","0","0","0","0","0",7330.57142857143,164361.428571429,7140,164354,8608,166089.333333333,2.81488029644341,4.46003146376018,4.34428124657751,5.18275305658802
"21",2020-10-21,"FR","France","Europe",20424,901350,261,33611,"2",7443,172601,"2","2","0","0","0","0","0","0",9115.85714285714,173477.285714286,8191.6,172545.6,5405.33333333333,171494.666666667,4.31225775053447,5.25478428217445,4.74749863224562,3.15189588014399
"22",2020-10-22,"FR","France","Europe",25820,927170,155,33766,"2",4124,176725,"2","0","0","0","0","0","0","0",10145.7142857143,183623,8865.4,181411,7525.66666666667,179020.333333333,2.33356910454095,5.52529600633596,4.88691424445045,4.2038055267465
"23",2020-10-23,"FR","France","Europe",41563,968733,162,33928,"2",11010,187735,"2","0","0","0","0","0","0","0",11329.1428571429,194952.142857143,10527.8,191938.8,10745,189765.333333333,5.86464963911897,5.8112430523242,5.48497750324583,5.66225654141255
"24",2020-10-24,"FR","France","Europe",41825,1010558,297,34225,"2",17101,204836,"0","0","0","0","0","0","0","0",12602.2857142857,207554.428571429,13442.4,205381.2,13690.6666666667,203456,8.34863012361108,6.07179803438822,6.54509760387027,6.72905525846702
"25",2020-10-25,"FR","France","Europe",45388,1055946,137,34362,"2",12961,217797,"0","0","0","0","0","0","0","0",13393.4285714286,220947.857142857,15329.8,220711,17359.3333333333,220815.333333333,5.95095432903116,6.0618051447174,6.94564385100879,7.86147097272834
"26",2020-10-26,"FR","France","Europe",51849,1107795,105,34467,"2",22016,239813,"0","0","0","0","0","0","0","0",14168.1428571429,235116,15724,236435,16179.3333333333,236994.666666667,9.1804864623686,6.02602241325255,6.65045361304375,6.82687655418406
"27",2020-10-27,"FR","France","Europe",26505,1134300,255,34722,"2",13561,253374,"0","0","0","0","0","0","0","0",13460,248576,14213.2,250648.2,16186,253180.666666667,5.35216715211506,5.4148429454171,5.67057732710628,6.39306318807913
"28",2020-10-28,"FR","France","Europe",33405,1167705,522,35244,"2",12981,266355,"0","0","0","0","0","0","0","0",11984,260560,12831.6,263479.8,12029.6666666667,265210.333333333,4.87357098608999,4.59932453177771,4.87005075910943,4.53589666566536
"29",2020-10-29,"FR","France","Europe",35367,1203072,240,35484,"2",9547,275902,"0","0","0","0","0","0","0","0",8295.57142857143,268855.571428571,9782.2,273262,9527,274737.333333333,3.46028662351125,3.08551218949739,3.57978789586551,3.46767579215056
"30",2020-10-30,"FR","France","Europe",47616,1250688,235,35719,"2",6053,281955,"0","0","0","0","0","0","0","0",4784.85714285714,273640.428571429,4498.4,277760.4,7456.33333333333,282193.666666667,2.14679647461474,1.7485929136411,1.61952531750386,2.64227522233549
"31",2020-10-31,"FR","France","Europe",48594,1299282,544,36263,"2",6769,288724,"0","0","0","2","2","2","2","2",6512,280152.428571429,1390.4,279150.8,-12,282181.666666667,2.34445352655131,2.32444888420436,0.498082040244914,-0.00425257960297444
"32",2020-11-01,"FR","France","Europe",32530,1331812,223,36486,"2",-12858,275866,"0","0","0","2","2","2","2","0",5064.57142857143,285217,4611.2,283762,-2882.66666666667,279299,-4.66095858134022,1.77569058947097,1.62502378754026,-1.03210776503556
"33",2020-11-02,"FR","France","Europe",49290,1381102,231,36717,"2",-2559,273307,"0","0","0","2","2","2","2","0",4335,289552,3970.4,287732.4,3411.33333333333,282710.333333333,-0.936309717643529,1.49714041001271,1.37989326193366,1.20665321748645
"34",2020-11-03,"FR","France","Europe",52156,1433258,411,37128,"2",25651,298958,"0","0","0","2","2","2","0","0",4956,294508,3504.6,291237,8647,291357.333333333,8.58013500224112,1.68280657910821,1.20334984909198,2.96783331350278
"35",2020-11-04,"FR","France","Europe",36254,1469512,854,37982,"2",2849,301807,"0","0","0","2","2","2","0","0",5651.57142857143,300159.571428571,8156.2,299393.2,10980,302337.333333333,0.943980755913547,1.88285564297467,2.72424356999424,3.63170498295502
"36",2020-11-05,"FR","France","Europe",39807,1509319,373,38355,"2",4440,306247,"0","0","0","2","2","0","0","0",15240.4285714286,315400,10995.6,310388.8,5896.33333333333,308233.666666667,1.44981012058894,4.83209529848718,3.54252473027377,1.91294267011715
"37",2020-11-06,"FR","France","Europe",58016,1567335,363,38718,"2",10400,316647,"0","0","0","2","2","0","0","0",14081.5714285714,329481.571428571,16718.2,327107,8826,317059.666666667,3.28441450574299,4.27385706809529,5.11092700553642,2.78370317258897
"38",2020-11-07,"FR","France","Europe",60232,1627567,827,39545,"2",11638,328285,"0","0","0","2","0","0","0","0",5762.14285714286,335243.714285714,14014.2,341121.2,25434,342493.666666667,3.54509039401739,1.71879221342597,4.10827588552104,7.42612272149071
"39",2020-11-08,"FR","France","Europe",86794,1714361,304,39849,"2",54264,382549,"0","0","0","2","0","0","0","0",3342.57142857143,338586.285714286,6609.2,347730.4,18410.3333333333,360904,14.1848495225448,0.98721406318035,1.90066787373206,5.10117187211373
"40",2020-11-09,"FR","France","Europe",38619,1752980,270,40119,"2",-10671,371878,"0","0","0","2","0","0","0","0",2017.42857142857,340603.714285714,1711.6,349442,3669.33333333333,364573.333333333,-2.86948945621951,0.592309621654994,0.489809467665593,1.00647332041107
"41",2020-11-10,"FR","France","Europe",19571,1772551,546,40665,"2",-32585,339293,"0","0","0","2","0","0","0","0",-3045.14285714286,337558.571428571,-1583.2,347858.8,-19114.6666666667,345458.666666667,-9.60379377116534,-0.902107993956604,-0.455127195287283,-5.53312697322207
"42",2020-11-11,"FR","France","Europe",22166,1794717,1220,41885,"2",-14088,325205,"0","0","0","2","0","0","0","0",-9938,327620.571428571,-17443.6,330415.2,-17169.6666666667,328289,-4.33203671530265,-3.0333870540137,-5.27929707834264,-5.23004629051435
"43",2020-11-12,"FR","France","Europe",34971,1829688,318,42203,"2",-4836,320369,"0","0","0","2","0","0","0","0",-25509.2857142857,302111.285714286,-22631.8,307783.4,-14654,313635,-1.5095093470342,-8.44367189195656,-7.35315809754522,-4.67231016946451
"44",2020-11-13,"FR","France","Europe",32978,1862666,425,42628,"2",-25038,295331,"0","0","0","2","0","0","0","0",-25627.1428571429,276484.142857143,-27061.8,280721.6,-22162,291473,-8.47794508534492,-9.26893766576125,-9.64008469601199,-7.60344868993011
"45",2020-11-14,"FR","France","Europe",23620,1886286,931,43559,"2",-36612,258719,"0","0","0","2","0","0","0","0",-22468.8571428571,254015.285714286,-26543.4,254178.2,-38795,252678,-14.1512606341243,-8.84547442870423,-10.4428310531745,-15.3535329549862
"46",2020-11-15,"FR","France","Europe",32059,1918345,354,43913,"2",-54735,203984,"0","0","0","2","0","0","0","0",-17123.1428571429,236892.142857143,-27671.6,226506.6,-34281,218397,-26.8329869009334,-7.22824431854159,-12.2166859597027,-15.6966441846729
"47",2020-11-16,"FR","France","Europe",27123,1945468,302,44215,"2",-11496,192488,"0","0","0","2","0","0","0","0",-17475.7142857143,219416.428571429,-17997.6,208509,-25569.3333333333,192827.666666667,-5.97232035243755,-7.96463345953389,-8.6315698602938,-13.2601995218528
"48",2020-11-17,"FR","France","Europe",9094,1954562,504,44719,"2",-10477,182011,"0","0","0","2","0","0","0","0",-15591.4285714286,203825,-12136,196373,453,193280.666666667,-5.7562455016455,-7.6494191445743,-6.18007567231748,0.234374191590123
"49",2020-11-18,"FR","France","Europe",45498,2000060,1219,45938,"2",23332,205343,"0","0","0","2","0","0","0","0",-10500.8571428571,193324.142857143,-3558.6,192814.4,1850.33333333333,195131,11.3624520923528,-5.43173604065415,-1.84560904164834,0.948251858153411
"50",2020-11-19,"FR","France","Europe",27667,2027727,413,46351,"2",-7304,198039,"0","0","0","2","0","0","0","0",-4710.85714285714,188613.285714286,-1455,191359.4,1393.33333333333,196524.333333333,-3.68816243265215,-2.49762742058013,-0.760349374005144,0.708987691091688
"51",2020-11-20,"FR","France","Europe",21130,2048857,429,46780,"2",-11848,186191,"0","0","0","2","0","0","0","0",-5063.71428571429,183549.571428571,-2200.6,189158.8,-6710,189814.333333333,-6.36335805704894,-2.75877205612808,-1.16336115475463,-3.53503335715778
"52",2020-11-21,"FR","France","Europe",22642,2071499,1137,47917,"2",-978,185213,"0","0","0","2","0","0","0","0",-4273.28571428571,179276.285714286,-9660.2,179498.6,-9010.33333333333,180804,-0.528040688288619,-2.3836313304126,-5.38176899429856,-4.98348119141907
"53",2020-11-22,"FR","France","Europe",17854,2089353,253,48170,"2",-14205,171008,"0","0","0","2","0","0","0","0",-12803.5714285714,166472.714285714,-9188.2,170310.4,-9716.33333333333,171087.666666667,-8.30662892964072,-7.69109309204683,-5.3949729435196,-5.67915474133144
"54",2020-11-23,"FR","France","Europe",13157,2102510,214,48384,"2",-13966,157042,"0","0","0","2","0","0","0","0",-13484.2857142857,152988.428571429,-14094.6,156215.8,-11038.3333333333,160049.333333333,-8.89316233873741,-8.81392523617566,-9.02251884892565,-6.89683181019186
"55",2020-11-24,"FR","France","Europe",4150,2106660,499,48883,"2",-4944,152098,"0","0","0","2","0","0","0","0",-12875.8571428571,140112.571428571,-16312.8,139903,-18430,141619.333333333,-3.25053583873555,-9.18965158627553,-11.6600787688613,-13.0137598915402
"56",2020-11-25,"FR","France","Europe",9118,2115778,1005,49888,"2",-36380,115718,"0","0","0","2","0","0","0","0",-14197.1428571429,125915.428571429,-14989.6,124913.4,-17797.6666666667,123821.666666667,-31.4384970358976,-11.2751415916352,-11.999993595563,-14.3736287402582
"57",2020-11-26,"FR","France","Europe",15598,2131376,371,50259,"2",-12069,103649,"0","0","0","2","0","0","0","0",-12935.7142857143,112979.714285714,-14241.8,110671.6,-18679.3333333333,105142.333333333,-11.6441065519204,-11.4495901919181,-12.8685227285049,-17.7657587968056
"58",2020-11-27,"FR","France","Europe",13541,2144917,339,50598,"2",-7589,96060,"0","0","0","2","0","0","0","0",-11438.7142857143,101541,-14328,96343.6,-9961.66666666667,95180.6666666667,-7.90027066416823,-11.2651188049303,-14.8717714513471,-10.466061034804
"59",2020-11-28,"FR","France","Europe",12415,2157332,956,51554,"2",-10227,85833,"0","0","0","2","0","0","0","0",-10783.2857142857,90757.7142857143,-7749.4,88594.2,-7730.33333333333,87450.3333333333,-11.9149977281465,-11.8813985115787,-8.74707373620395,-8.83968423981612
"60",2020-11-29,"FR","France","Europe",12479,2169811,213,51767,"2",-5375,80458,"0","0","0","2","0","0","0","0",-5746,85011.7142857143,-5406.8,83187.4,-6363,81087.3333333333,-6.68050411394765,-6.75906849812295,-6.4995419979468,-7.84709490179313
"61",2020-11-30,"FR","France","Europe",9670,2179481,198,51965,"2",-3487,76971,"0","0","0","2","0","0","0","0",-4259,80752.7142857143,-4112.8,79074.6,-3072.66666666667,78014.6666666667,-4.53027763703213,-5.27412612402237,-5.2011644700068,-3.93857565244142
"62",2020-10-01,"DE","Germany","Europe",2503,291722,12,9500,"0",360,13652,"0","0","0","0","0","0","0","0",338.857142857143,13814.1428571429,246.6,13721.4,303,13705.3333333333,2.6369762672136,2.45297262639738,1.79719270628362,2.21081817297402
"63",2020-10-02,"DE","Germany","Europe",2673,294395,8,9508,"0",520,14172,"0","0","0","0","0","0","0","0",327.428571428571,14141.5714285714,366.8,14088.2,312,14017.3333333333,3.66920688681908,2.3153620026063,2.6035973367783,2.22581565680586
"64",2020-10-03,"DE","Germany","Europe",2563,296958,19,9527,"0",56,14228,"0","0","0","0","0","0","0","0",367.714285714286,14509.2857142857,399,14487.2,481.666666666667,14499,0.393590104020242,2.53433761630483,2.75415539234635,3.32206818861071
"65",2020-10-04,"DE","Germany","Europe",2279,299237,2,9529,"0",869,15097,"0","0","0","0","0","0","0","0",510.714285714286,15020,437,14924.2,371.666666666667,14870.6666666667,5.75611048552693,3.40022826707248,2.92813015102987,2.49932753519233
"66",2020-10-05,"DE","Germany","Europe",1382,300619,5,9534,"0",190,15287,"0","0","0","0","0","0","0","0",681.428571428571,15701.4285714286,539,15463.2,536.333333333333,15407,1.24288611238307,4.33991447547994,3.48569506958456,3.48110166374592
"67",2020-10-06,"DE","Germany","Europe",2639,303258,12,9546,"0",550,15837,"0","0","0","0","0","0","0","0",870.428571428571,16571.8571428571,838.8,16302,590,15997,3.47287996463977,5.25245036766291,5.14538093485462,3.68819153591298
"68",2020-10-07,"DE","Germany","Europe",2828,306086,16,9562,"0",1030,16867,"0","0","0","0","0","0","0","0",1170.71428571429,17742.5714285714,1033.6,17335.6,1045,17042,6.10659868382048,6.59833491682636,5.96229723805348,6.13190940030513
"69",2020-10-08,"DE","Germany","Europe",4058,310144,16,9578,"0",1555,18422,"0","0","0","0","0","0","0","0",1218.57142857143,18961.1428571429,1427.2,18762.8,1476,18518,8.4409944631419,6.42667711409801,7.60654060161596,7.97062317744897
"70",2020-10-09,"DE","Germany","Europe",4516,314660,11,9589,"0",1843,20265,"0","0","0","0","0","0","0","0",1346.42857142857,20307.5714285714,1558,20320.8,1852,20370,9.09449790278806,6.63018015799878,7.66702098342585,9.09180166912126
"71",2020-10-10,"DE","Germany","Europe",4721,319381,15,9604,"0",2158,22423,"0","0","0","0","0","0","0","0",1479.71428571429,21787.2857142857,1569,21889.8,1735,22105,9.62404673772466,6.79164125866331,7.16772195269029,7.84890296313051
"72",2020-10-11,"DE","Germany","Europe",3483,322864,11,9615,"0",1204,23627,"0","0","0","0","0","0","0","0",1661.71428571429,23449,1554.6,23444.4,1482.33333333333,23587.3333333333,5.0958649003259,7.08650384116289,6.63100783129447,6.28444645431164
"73",2020-10-12,"DE","Germany","Europe",2467,325331,6,9621,"0",1085,24712,"0","0","0","0","0","0","0","0",1808.14285714286,25257.1428571429,1646.8,25091.2,1257.33333333333,24844.6666666667,4.39057947555843,7.15893665158371,6.56325723759725,5.06077763168487
"74",2020-10-13,"DE","Germany","Europe",4122,329453,13,9634,"0",1483,26195,"0","0","0","0","0","0","0","0",1947.42857142857,27204.5714285714,1731.2,26822.4,1624,26468.6666666667,5.66138576064134,7.15846076289699,6.45430684800763,6.13555650706496
"75",2020-10-14,"DE","Germany","Europe",5132,334585,43,9677,"0",2304,28499,"0","0","0","0","0","0","0","0",2083.28571428571,29287.8571428571,2054,28876.4,2122.33333333333,28591,8.08449419277869,7.11313806306856,7.11307503705448,7.42308185559558
"76",2020-10-15,"DE","Germany","Europe",6638,341223,33,9710,"1",2580,31079,"1","1","1","0","0","0","0","0",2211.85714285714,31499.7142857143,2458.8,31335.2,2567.33333333333,31158.3333333333,8.30142539978764,7.02183239757277,7.84676657560826,8.23963626638139
"77",2020-10-16,"DE","Germany","Europe",7334,348557,24,9734,"1",2818,33897,"1","1","1","0","0","0","0","0",2322.28571428571,33822,2583,33918.2,2835.66666666667,33994,8.31342006667257,6.86619867034981,7.61538053316509,8.34166813751446
"78",2020-10-17,"DE","Germany","Europe",7830,356387,33,9767,"1",3109,37006,"1","1","1","0","0","0","0","0",2502.71428571429,36324.7142857143,2493.8,36412,2677,36671,8.40134032319083,6.88983887396617,6.84884104141492,7.30004635815767
"79",2020-10-18,"DE","Germany","Europe",5587,361974,10,9777,"1",2104,39110,"1","1","0","0","0","0","0","0",2525.42857142857,38850.1428571429,2527,38939,2357,39028,5.37969828688315,6.50043574026203,6.48963763835743,6.03925386901712
"80",2020-10-19,"DE","Germany","Europe",4325,366299,12,9789,"1",1858,40968,"1","1","0","0","0","0","0","0",2821,41671.1428571429,2456,41395,2236,41264,4.535247022066,6.7696727437281,5.93308370576157,5.41876696393951
"81",2020-10-20,"DE","Germany","Europe",6868,373167,47,9836,"1",2746,43714,"1","0","0","0","0","0","0","0",2976.71428571429,44647.8571428571,2764,44159,2355.66666666667,43619.6666666667,6.28174040353205,6.66709328555202,6.25919971013836,5.40046920731474
"82",2020-10-21,"DE","Germany","Europe",7595,380762,39,9875,"1",2463,46177,"1","0","0","0","0","0","0","0",3516,48163.8571428571,3124.8,47283.8,3286,46905.6666666667,5.33382419819391,7.30007978715516,6.60860590730863,7.00555014674844
"83",2020-10-22,"DE","Germany","Europe",11287,392049,30,9905,"2",4649,50826,"1","1","1","0","0","0","0","0",4013.85714285714,52177.7142857143,4130,51413.8,3673.33333333333,50579,9.14689332231535,7.69266572483052,8.03286277225181,7.26256615064223
"84",2020-10-23,"DE","Germany","Europe",11242,403291,49,9954,"2",3908,54734,"1","1","1","0","0","0","0","0",4371.28571428571,56549,4698.6,56112.4,5147,55726,7.13998611466365,7.73008490740016,8.37355023132142,9.23626314467215
"85",2020-10-24,"DE","Germany","Europe",14714,418005,49,10003,"2",6884,61618,"1","1","1","0","0","0","0","0",4627.71428571429,61176.7142857143,5078,61190.4,5460.33333333333,61186.3333333333,11.1720601123048,7.56450283371124,8.29868737579751,8.92410614570792
"86",2020-10-25,"DE","Germany","Europe",11176,429181,29,10032,"2",5589,67207,"1","1","0","0","0","0","0","0",5328.57142857143,66505.2857142857,5056.4,66246.8,5611,66797.3333333333,8.3160980255033,8.01225251698576,7.63267055918172,8.40003592957803
"87",2020-10-26,"DE","Germany","Europe",8685,437866,24,10056,"2",4360,71567,"1","1","0","0","0","0","0","0",5448.28571428571,71953.5714285714,5748.6,71995.4,4830,71627.3333333333,6.09219332932776,7.57194619546334,7.98467679879548,6.74323582245139
"88",2020-10-27,"DE","Germany","Europe",11409,449275,42,10098,"2",4541,76108,"1","0","0","0","0","0","0","0",5952.71428571429,77906.2857142857,5469.2,77464.6,5423.33333333333,77050.6666666667,5.96652125926315,7.64086521535031,7.06025720135391,7.03865854502665
"89",2020-10-28,"DE","Germany","Europe",14964,464239,85,10183,"2",7369,83477,"1","0","0","0","0","0","0","0",5590,83496.2857142857,5839.2,83303.8,5799,82849.6666666667,8.82758124992513,6.69490858447082,7.00952417536775,6.99942466073088
"90",2020-10-29,"DE","Germany","Europe",16774,481013,89,10272,"2",5487,88964,"0","0","0","1","1","1","1","1",5220.28571428571,88716.5714285714,5836.2,89140,6765,89614.6666666667,6.16766332449081,5.88422842567663,6.54722907785506,7.54898751692431
"91",2020-10-30,"DE","Germany","Europe",18681,499694,77,10349,"2",7439,96403,"0","0","0","1","1","1","1","0",5084.85714285714,93801.4285714286,5528.2,94668.2,5757,95371.6666666667,7.71656483719386,5.42087388251778,5.83955330300988,6.03638397148
"92",2020-10-31,"DE","Germany","Europe",19059,518753,103,10452,"2",4345,100748,"0","0","0","1","1","1","1","0",4999.42857142857,98800.8571428571,4736.8,99405,4928.33333333333,100300,4.31274069956724,5.06010647680905,4.76515265831699,4.91359255566633
"93",2020-11-01,"DE","Germany","Europe",14177,532930,29,10481,"2",3001,103749,"0","0","0","1","1","1","0","0",4268.14285714286,103069,4428,103833,3586,103886,2.89255800055904,4.1410539125662,4.26454017508884,3.45186069345244
"94",2020-11-02,"DE","Germany","Europe",12097,545027,49,10530,"1",3412,107161,"-1","-1","-1","1","1","1","0","0",3943.71428571429,107012.714285714,3390.2,107223.2,3452,107338,3.18399417698603,3.68527638237913,3.16181572644726,3.21600924183421
"95",2020-11-03,"DE","Germany","Europe",15352,560379,131,10661,"1",3943,111104,"-1","-1","-1","1","1","0","0","0",3284.57142857143,110297.285714286,3164.4,110387.6,3201.66666666667,110539.666666667,3.54892713133641,2.97792589119535,2.86662632397117,2.89639616547906
"96",2020-11-04,"DE","Germany","Europe",17214,577593,151,10812,"1",2250,113354,"-1","-1","-1","1","1","0","0","0",3283.85714285714,113581.142857143,3129.2,113516.8,3136.33333333333,113676,1.98493215942975,2.89119924333516,2.75659638044765,2.75901099029992
"97",2020-11-05,"DE","Germany","Europe",19990,597583,118,10930,"1",3216,116570,"-1","-1","0","2","1","1","1","1",3118,116699.142857143,3314.8,116831.6,2763.66666666667,116439.666666667,2.75885733893798,2.67182767898895,2.83724608753111,2.3734752475531
"98",2020-11-06,"DE","Germany","Europe",21506,619089,166,11096,"1",2825,119395,"-1","-1","0","2","1","1","1","0",2811.42857142857,119510.571428571,2894.2,119725.8,3460.33333333333,119900,2.36609573265212,2.35245178549656,2.41735699406477,2.88601612454823
"99",2020-11-07,"DE","Germany","Europe",23399,642488,130,11226,"1",4340,123735,"-1","0","0","2","1","1","1","0",2245.28571428571,121755.857142857,2697.4,122423.2,3001.66666666667,122901.666666667,3.50749585808381,1.84408846274336,2.20334054329572,2.44233194559336
"100",2020-11-08,"DE","Germany","Europe",16017,658505,63,11289,"1",1840,125575,"-1","0","0","2","1","1","0","0",2105.71428571429,123861.571428571,2050.2,124473.4,2482,125383.666666667,1.46525980489747,1.70005455398942,1.6470988982385,1.97952418044881
"101",2020-11-09,"DE","Germany","Europe",13363,671868,63,11352,"1",1266,126841,"0","0","0","2","1","1","0","0",1914.28571428571,125775.857142857,1739.8,126213.2,1028.66666666667,126412.333333333,0.998099983443839,1.52198184752695,1.37846120691021,0.813739165745958
"102",2020-11-10,"DE","Germany","Europe",15332,687200,154,11506,"1",-20,126821,"0","0","0","2","1","0","0","0",1801.57142857143,127577.428571429,1247,127460.2,839.666666666667,127252,-0.0157702588687993,1.41213963061088,0.97834461267125,0.65984555580004
"103",2020-11-11,"DE","Germany","Europe",18487,705687,261,11767,"1",1273,128094,"0","0","0","2","1","0","0","0",1047.57142857143,128625,1286.2,128746.4,1043,128295,0.99380142707699,0.814438428432598,0.999018224975611,0.812970107954324
"104",2020-11-12,"DE","Germany","Europe",21866,727553,215,11982,"1",1876,129970,"0","0","0","2","0","0","0","0",917.571428571429,129542.571428571,845.4,129591.8,1728.33333333333,130023.333333333,1.44341001769639,0.708316515916444,0.652356090431648,1.32924859640577
"105",2020-11-13,"DE","Germany","Europe",23542,751095,218,12200,"1",2036,132006,"0","0","0","2","0","0","0","0",374,129916.571428571,1035.4,130627.2,991.333333333333,131014.666666667,1.54235413541809,0.287877055165073,0.792637368021362,0.756658287621742
"106",2020-11-14,"DE","Germany","Europe",22461,773556,178,12378,"1",-938,131068,"0","0","0","2","0","0","0","0",246.428571428571,130163,273,130900.2,676,131690.666666667,-0.715659047212134,0.189323057572867,0.208555831083528,0.513324153572007
"107",2020-11-15,"DE","Germany","Europe",16947,790503,107,12485,"1",930,131998,"0","0","0","2","0","0","0","0",-67.7142857142857,130095.285714286,-284.8,130615.4,-849,130841.666666667,0.704556129638328,-0.0520497613287843,-0.218044732856922,-0.648875867779122
"108",2020-11-16,"DE","Germany","Europe",10824,801327,62,12547,"1",-2539,129459,"0","0","0","1","-1","-1","-1","-1",-229.571428571429,129865.714285714,-877.2,129738.2,-840.666666666667,130001,-1.96123869333148,-0.176776010384353,-0.676130854289639,-0.646661692345956
"109",2020-11-17,"DE","Germany","Europe",14419,815746,267,12814,"1",-913,128546,"0","0","0","1","-1","-1","-1","0",-505.285714285714,129360.428571429,-541,129197.2,-1459.33333333333,128541.666666667,-0.710251583090878,-0.390602999592501,-0.41873972500952,-1.13529983792545
"110",2020-11-18,"DE","Germany","Europe",17561,833307,305,13119,"1",-926,127620,"0","0","0","1","-1","-1","-1","0",-299.428571428571,129061,-705.8,128491.4,-365.333333333333,128176.333333333,-0.725591600062686,-0.232005463640117,-0.549297462709567,-0.285024016394082
"111",2020-11-19,"DE","Germany","Europe",22609,855916,251,13370,"1",743,128363,"0","0","0","1","-1","-1","0","0",-604.571428571429,128456.428571429,-97.4,128394,-25.6666666666667,128150.666666667,0.578827232146335,-0.470643186405618,-0.0758602426904684,-0.0200285081102452
"112",2020-11-20,"DE","Germany","Europe",23648,879564,260,13630,"1",106,128469,"0","0","0","1","-1","-1","0","0",-236.142857142857,128220.285714286,-156,128238,450.666666666667,128601.333333333,0.0825101775525613,-0.184169654456282,-0.12164880924531,0.350437009465946
"113",2020-11-21,"DE","Germany","Europe",22964,902528,254,13884,"1",503,128972,"0","0","0","1","-1","0","0","0",-229.285714285714,127991,37.2,128275.2,-199,128402.333333333,0.390007133331266,-0.179142060211823,0.0290001496781919,-0.154981607291664
"114",2020-11-22,"DE","Germany","Europe",15741,918269,138,14022,"1",-1206,127766,"0","0","0","1","-1","0","0","0",56.1428571428571,128047.142857143,-284.4,127990.8,-221,128181.333333333,-0.943913091119703,0.0438454587038256,-0.222203470874469,-0.172411999667138
"115",2020-11-23,"DE","Germany","Europe",10864,929133,90,14112,"1",40,127806,"0","0","0","1","0","0","0","0",-98.7142857142857,127948.428571429,-91.2,127899.6,-677,127504.333333333,0.0312974351751874,-0.0771516202398511,-0.071305930589306,-0.53096234637777
"116",2020-11-24,"DE","Germany","Europe",13554,942687,249,14361,"1",-865,126941,"0","0","0","1","0","0","0","0",-234.142857142857,127714.285714286,-260,127639.6,82.3333333333333,127586.666666667,-0.681418926903049,-0.183333333333333,-0.203698538698022,0.06453129898631
"117",2020-11-25,"DE","Germany","Europe",18633,961320,410,14771,"1",1072,128013,"0","0","0","1","0","0","0","0",-487.285714285714,127227,-187.2,127452.4,-44.6666666666667,127542,0.837414950044136,-0.383004955147661,-0.146878364000992,-0.0350211433619252
"118",2020-11-26,"DE","Germany","Europe",22268,983588,389,15160,"1",-341,127672,"0","0","0","1","0","0","0","0",-476.428571428571,126750.571428571,-449,127003.4,-37,127505,-0.267090669841469,-0.375878835147545,-0.35353384240107,-0.0290184698639269
"119",2020-11-27,"DE","Germany","Europe",22806,1006394,426,15586,"1",-842,126830,"0","0","0","1","0","0","0","0",-438.571428571429,126312,-502,126501.4,-817.333333333333,126687.666666667,-0.663880785303162,-0.347212797336301,-0.396833552830245,-0.645156197788261
"120",2020-11-28,"DE","Germany","Europe",21695,1028089,379,15965,"1",-1269,125561,"0","0","0","1","0","0","0","0",-307.857142857143,126004.142857143,-655.4,125846,-1080.33333333333,125607.333333333,-1.01066413934263,-0.244323032462651,-0.520795257695914,-0.860087786806503
"121",2020-11-29,"DE","Germany","Europe",14611,1042700,158,16123,"1",-1130,124431,"0","0","0","1","0","0","0","0",-655.714285714286,125348.428571429,-577.2,125268.8,-698,124909.333333333,-0.908133825172184,-0.523113287647346,-0.460769161994048,-0.558805320125531
"122",2020-11-30,"DE","Germany","Europe",11169,1053869,125,16248,"1",305,124736,"0","0","0","1","0","0","0","0",-638.714285714286,124709.714285714,-681.4,124587.4,-258.333333333333,124651,0.244516418676244,-0.512160812309271,-0.546925291000535,-0.207245295531791
"123",2020-10-01,"IT","Italy","Europe",1850,314861,19,35894,"0",210,12324,"0","0","0","0","0","0","0","0",444.571428571429,12773.7142857143,391.8,12611,409.333333333333,12508,1.70399221032132,3.48036145656258,3.10681151375783,3.27257222044558
"124",2020-10-02,"IT","Italy","Europe",2548,317409,24,35918,"0",762,13086,"0","0","0","0","0","0","0","0",535,13308.7142857143,557.8,13168.8,519.666666666667,13027.6666666667,5.82301696469509,4.01992249975848,4.23576939432598,3.98894660082389
"125",2020-10-03,"IT","Italy","Europe",2499,319908,23,35941,"0",587,13673,"0","0","0","0","0","0","0","0",623.428571428571,13932.1428571429,669,13837.8,774.333333333333,13802,4.29313245081548,4.47475006408613,4.83458353206435,5.6102980244409
"126",2020-10-04,"IT","Italy","Europe",2843,322751,27,35968,"0",974,14647,"0","0","0","0","0","0","0","0",734,14666.1428571429,779.6,14617.4,791,14593,6.64982590291527,5.00472419469526,5.33336981953015,5.42040704447338
"127",2020-10-05,"IT","Italy","Europe",2578,325329,18,35986,"0",812,15459,"0","0","0","0","0","0","0","0",965,15631.1428571429,833.2,15450.6,849.666666666667,15442.6666666667,5.25260366129763,6.17357290390978,5.39267083478959,5.50207218097047
"128",2020-10-06,"IT","Italy","Europe",2257,327586,16,36002,"0",763,16222,"0","0","0","0","0","0","0","0",1129,16760.1428571429,1081.2,16531.8,868.333333333333,16311,4.70348908889163,6.73621943215622,6.54012267266722,5.32360574663315
"129",2020-10-07,"IT","Italy","Europe",2677,330263,28,36030,"0",1030,17252,"0","0","0","0","0","0","0","0",1455.57142857143,18215.7142857143,1268.4,17800.2,1206.66666666667,17517.6666666667,5.97032228147461,7.99074582385695,7.12576263188054,6.88828420832303
"130",2020-10-08,"IT","Italy","Europe",3677,333940,31,36061,"0",1827,19079,"0","0","0","0","0","0","0","0",1728,19943.7142857143,1680.6,19480.8,1589,19106.6666666667,9.57597358352115,8.66438405226136,8.62695577183689,8.31646894626657
"131",2020-10-09,"IT","Italy","Europe",4458,338398,22,36083,"0",1910,20989,"0","0","0","0","0","0","0","0",2023.14285714286,21966.8571428571,2104.2,21585,2203.33333333333,21310,9.1000047644004,9.20997866916394,9.74843641417651,10.3394337556703
"132",2020-10-10,"IT","Italy","Europe",5372,343770,28,36111,"0",2873,23862,"0","0","0","0","0","0","0","0",2251.57142857143,24218.4285714286,2473.8,24058.8,2554.66666666667,23864.6666666667,12.0400636996061,9.29693444779359,10.2823083445558,10.7048076654468
"133",2020-10-11,"IT","Italy","Europe",5724,349494,29,36140,"0",2881,26743,"0","0","0","0","0","0","0","0",2564.57142857143,26783,2580.8,26639.6,2877.33333333333,26742,10.7729125378604,9.57537030419082,9.68783315064791,10.7596041183656
"134",2020-10-12,"IT","Italy","Europe",5456,354950,26,36166,"0",2878,29621,"0","0","0","0","0","0","0","0",2825.71428571429,29608.7142857143,2843,29482.6,2707,29449,9.71607980824415,9.54352241859298,9.64297585694613,9.19216272199396
"135",2020-10-13,"IT","Italy","Europe",4619,359569,39,36205,"0",2362,31983,"0","0","0","0","0","0","0","0",3173.57142857143,32782.2857142857,2999.4,32482,2820.33333333333,32269.3333333333,7.38517337335459,9.68075092820164,9.23403731297334,8.73998016692835
"136",2020-10-14,"IT","Italy","Europe",5898,365467,41,36246,"0",3221,35204,"0","0","0","0","0","0","0","0",3425.57142857143,36207.8571428571,3292.2,35774.2,3079.33333333333,35348.6666666667,9.1495284626747,9.46085103864591,9.20272151438746,8.71131395809366
"137",2020-10-15,"IT","Italy","Europe",7332,372799,43,36289,"0",3655,38859,"0","0","0","0","0","0","0","0",3757,39964.8571428571,3644,39418.2,3740.33333333333,39089,9.40580045806634,9.4007592384738,9.24446068059932,9.56876188527037
"138",2020-10-16,"IT","Italy","Europe",8803,381602,83,36372,"0",4345,43204,"0","0","0","0","0","0","0","0",4238.57142857143,44203.4285714286,4211.8,43630,4212.33333333333,43301.3333333333,10.0569391722989,9.5887843218367,9.65344946137978,9.72795294987067
"139",2020-10-17,"IT","Italy","Europe",10009,391611,55,36427,"0",4637,47841,"0","0","0","0","0","0","0","0",4575.14285714286,48778.5714285714,4817.4,48447.4,4727.66666666667,48029,9.69252314959972,9.37941133401669,9.94356766307376,9.84335852644583
"140",2020-10-18,"IT","Italy","Europe",10925,402536,47,36474,"0",5201,53042,"0","0","0","0","0","0","0","0",4825.42857142857,53604,5030,53477.4,5362.33333333333,53391.3333333333,9.80543720070887,9.00199345464624,9.40584246803322,10.0434527451397
"141",2020-10-19,"IT","Italy","Europe",11705,414241,69,36543,"0",6249,59291,"0","0","0","0","0","0","0","0",5427.14285714286,59031.1428571429,5155.6,58633,5389.33333333333,58780.6666666667,10.5395422576782,9.19369436955796,8.7930005287125,9.16854748159826
"142",2020-10-20,"IT","Italy","Europe",9337,423578,73,36616,"0",4718,64009,"0","0","0","0","0","0","0","0",5845.71428571429,64876.8571428571,5801.6,64434.6,5313.33333333333,64094,7.37083847583934,9.01047699157525,9.00385817557648,8.28990753164623
"143",2020-10-21,"IT","Italy","Europe",10871,434449,89,36705,"0",4973,68982,"0","0","0","0","0","0","0","0",6488.14285714286,71365,6216.4,70651,5852.66666666667,69946.6666666667,7.20912701864254,9.09149142737036,8.79874311757795,8.36732748760961
"144",2020-10-22,"IT","Italy","Europe",15199,449648,127,36832,"0",7867,76849,"0","0","0","0","0","0","0","0",6990.14285714286,78355.1428571429,6793.4,77444.4,6705,76651.6666666667,10.2369581907377,8.92110281757419,8.77197060084396,8.74736361462025
"145",2020-10-23,"IT","Italy","Europe",16078,465726,136,36968,"2",7275,84124,"2","2","2","0","0","0","0","0",7464.28571428571,85819.4285714286,7592.8,85037.2,8092,84743.6666666667,8.64794826684418,8.69766419858307,8.9287982200731,9.54879617355869
"146",2020-10-24,"IT","Italy","Europe",19143,484869,91,37059,"2",9134,93258,"2","2","2","0","0","0","0","0",7886,93705.4285714286,8511.8,93549,8374.66666666667,93118.3333333333,9.79433399815565,8.41573441392327,9.0987610770826,8.9935744840794
"147",2020-10-25,"IT","Italy","Europe",19640,504509,151,37210,"2",8715,101973,"2","2","2","0","0","0","0","0",8763.85714285714,102469.285714286,8472.4,102021.4,9139,102257.333333333,8.54637992409756,8.5526673497982,8.30453218638443,8.93725633369408
"148",2020-10-26,"IT","Italy","Europe",21273,525782,128,37338,"2",9568,111541,"2","2","0","0","0","0","0","0",9038.42857142857,111507.714285714,9241,111262.4,8651,110908.333333333,8.57801167283779,8.105653164291,8.30559110714851,7.80013524682546
"149",2020-10-27,"IT","Italy","Europe",17007,542789,141,37479,"2",7670,119211,"2","2","0","0","0","0","0","0",9535,121042.714285714,9372,120634.4,9452,120360.333333333,6.43397001954518,7.87738448882862,7.76892826590094,7.85308559575275
"150",2020-10-28,"IT","Italy","Europe",21989,564778,221,37700,"2",11118,130329,"2","0","0","0","0","0","0","0",9935.28571428571,130978,9779.2,130413.6,9525.66666666667,129886,8.53071841263264,7.58546146244844,7.49860444002773,7.33386713476946
"151",2020-10-29,"IT","Italy","Europe",24988,589766,205,37905,"2",9789,140118,"2","0","0","0","0","0","0","0",10421.1428571429,141399.142857143,10252.8,140666.4,10552.6666666667,140438.666666667,6.98625444268402,7.37001840787073,7.2887341966525,7.5140749461212
"152",2020-10-30,"IT","Italy","Europe",26829,616595,217,38122,"2",10751,150869,"0","0","0","0","0","0","0","0",10287.4285714286,151686.571428571,11142,151808.4,10825.3333333333,151264,7.1260497517714,6.7820298623289,7.33951480945718,7.156582751569
"153",2020-10-31,"IT","Italy","Europe",31079,647674,199,38321,"2",11936,162805,"0","0","0","0","0","0","0","0",9941.14285714286,161627.714285714,10644.8,162453.2,11601,162865,7.33147016369276,6.1506424817526,6.55253328343178,7.12307739538882
"154",2020-11-01,"IT","Italy","Europe",31756,679430,297,38618,"2",12116,174921,"0","0","0","0","0","0","0","0",9246,170873.714285714,9736.2,172189.4,10894.6666666667,173759.666666667,6.92655541644514,5.41101364750576,5.65435502998443,6.26996291813021
"155",2020-11-02,"IT","Italy","Europe",29905,709335,208,38826,"2",8632,183553,"0","0","0","0","0","0","0","0",8641.85714285714,179515.571428571,8836.4,181025.8,8664.66666666667,182424.333333333,4.70272891208534,4.81398748536737,4.88129316373688,4.7497318522931
"156",2020-11-03,"IT","Italy","Europe",22253,731588,233,39059,"2",5246,188799,"0","0","0","0","0","0","0","0",8202.14285714286,187717.714285714,7561.2,188587,6710,189134.333333333,2.7786164121632,4.369402689753,4.00939619379915,3.54774296223319
"157",2020-11-04,"IT","Italy","Europe",28241,759829,353,39412,"2",6252,195051,"0","0","0","0","0","0","0","0",7457.42857142857,195175.142857143,6672.6,195259.6,5686,194820.333333333,3.20531553286064,3.82089054080364,3.41729676799502,2.91858652673147
"158",2020-11-05,"IT","Italy","Europe",30548,790377,352,39764,"2",5560,200611,"0","0","0","0","0","0","0","0",6877,202052.142857143,6290.8,201550.4,6495,201315.333333333,2.77153296678647,3.40357687018556,3.1212044233105,3.22628181989781
"159",2020-11-06,"IT","Italy","Europe",34502,824879,428,40192,"2",7673,208284,"0","0","0","2","2","2","2","2",6030.85714285714,208083,6852.2,208402.6,6652,207967.333333333,3.68391235044459,2.89829401866426,3.28796281812223,3.19857926405108
"160",2020-11-07,"IT","Italy","Europe",37802,862681,446,40638,"2",6723,215007,"0","0","0","2","2","2","2","0",5712.28571428571,213795.285714286,6143.6,214546.2,7483,215450.333333333,3.12687493895548,2.67184830348391,2.86353242331955,3.4731902634946
"161",2020-11-08,"IT","Italy","Europe",39809,902490,425,41063,"2",8053,223060,"0","0","0","2","2","2","2","0",5797.57142857143,219592.857142857,5634.8,220181,5828.33333333333,221278.666666667,3.61023939747153,2.64014572422991,2.55916723059665,2.63393368241554
"162",2020-11-09,"IT","Italy","Europe",32614,935104,331,41394,"2",2709,225769,"0","0","0","2","2","2","0","0",5348,224940.857142857,5470,225651,4592.66666666667,225871.333333333,1.19989901182182,2.37751383538276,2.42409738933131,2.03331100006789
"163",2020-11-10,"IT","Italy","Europe",25269,960373,356,41750,"2",3016,228785,"0","0","0","2","2","2","0","0",4748.28571428571,229689.142857143,4608,230259,4191.33333333333,230062.666666667,1.31826824311034,2.06726606892297,2.00122470782901,1.82182245996743
"164",2020-11-11,"IT","Italy","Europe",35090,995463,580,42330,"2",6849,235634,"0","0","0","2","2","0","0","0",4230.71428571429,233919.857142857,3692.4,233951.4,4092.66666666667,234155.333333333,2.9066263781967,1.80861699275515,1.57827651384005,1.74784260021126
"165",2020-11-12,"IT","Italy","Europe",32961,1028424,623,42953,"2",2413,238047,"0","0","0","2","2","0","0","0",2714.57142857143,236634.428571429,3770.6,237722,4245.66666666667,238401,1.01366536860368,1.1471582748797,1.58613843060381,1.78089297723863
"166",2020-11-13,"IT","Italy","Europe",37977,1066401,636,43589,"2",3475,241522,"0","0","0","2","0","0","0","0",2522.28571428571,239156.714285714,2655.4,240377.4,2996,241397,1.43879232533682,1.05465812315535,1.10467955806161,1.24110904443717
"167",2020-11-14,"IT","Italy","Europe",40902,1107303,550,44139,"2",3100,244622,"0","0","0","2","0","0","0","0",2389,241545.714285714,1558.2,241935.6,1338.33333333333,242735.333333333,1.26726132563711,0.989046734720431,0.644055690853268,0.551354973729961
"168",2020-11-15,"IT","Italy","Europe",37249,1144552,544,44683,"2",-2560,242062,"0","0","0","2","0","0","0","0",996.428571428571,242542.142857143,1492.2,243427.8,634.333333333333,243369.666666667,-1.05758028934736,0.410826984412135,0.612994900335952,0.260646013129546
"169",2020-11-16,"IT","Italy","Europe",33977,1178529,546,45229,"2",1363,243425,"0","0","0","2","0","0","0","0",840.142857142857,243382.285714286,217.4,243645.2,295.333333333333,243665,0.559926055253158,0.345194743601483,0.0892281070999962,0.121204659402595
"170",2020-11-17,"IT","Italy","Europe",27352,1205881,504,45733,"2",2083,245508,"0","0","0","2","0","0","0","0",86.4285714285714,243468.714285714,-138.8,243506.4,182.333333333333,243847.333333333,0.848444857194063,0.0354988408601633,-0.0570005552215465,0.0747735605064371
"171",2020-11-18,"IT","Italy","Europe",32191,1238072,731,46464,"2",-2899,242609,"0","0","0","2","0","0","0","0",-879.714285714286,242589,13,243519.4,167.666666666667,244015,-1.19492681640005,-0.362635686578652,0.00533838371809392,0.068711622919356
"172",2020-11-19,"IT","Italy","Europe",34280,1272352,753,47217,"2",1319,243928,"0","0","0","2","0","0","0","0",-869,241720,-992.2,242527.2,-1127,242888,0.540733331146896,-0.359506867449942,-0.409108751513232,-0.463999868252034
"173",2020-11-20,"IT","Italy","Europe",36176,1308528,653,47870,"2",-1801,242127,"0","0","0","2","0","0","0","0",-1869.42857142857,239850.571428571,-1905.8,240621.4,-1381.66666666667,241506.333333333,-0.743824521841843,-0.779413849337147,-0.792032628851798,-0.572103699143846
"174",2020-11-21,"IT","Italy","Europe",37239,1345767,699,48569,"2",-3663,238464,"0","0","0","2","0","0","0","0",-2799.14285714286,237051.428571429,-2454,238167.4,-2649.66666666667,238856.666666667,-1.5360809178744,-1.18081670041462,-1.03036771615259,-1.10931241888441
"175",2020-11-22,"IT","Italy","Europe",34764,1380531,692,49261,"2",-2485,235979,"0","0","0","2","0","0","0","0",-3665.57142857143,233385.857142857,-3602.8,234564.6,-3929.33333333333,234927.333333333,-1.05305980616919,-1.57060563713923,-1.53595214282121,-1.67257393066225
"176",2020-11-23,"IT","Italy","Europe",28337,1408868,562,49823,"2",-5640,230339,"0","0","0","2","0","0","0","0",-5058,228327.857142857,-5035.4,229529.2,-4183.33333333333,230744,-2.44856494123878,-2.21523561044738,-2.1937949507078,-1.81297599648673
"177",2020-11-24,"IT","Italy","Europe",22927,1431795,630,50453,"2",-4425,225914,"0","0","0","2","0","0","0","0",-5825.71428571429,222502.142857143,-5988.4,223540.8,-6343,224401,-1.95870995157449,-2.61827333926158,-2.67888457051241,-2.82663624493652
"178",2020-11-25,"IT","Italy","Europe",23227,1455022,853,51306,"2",-8964,216950,"0","0","0","2","0","0","0","0",-6573.42857142857,215928.714285714,-6926.4,216614.4,-7272.33333333333,217128.666666667,-4.1318276100484,-3.04425865414578,-3.19757135259706,-3.34931975817718
"179",2020-11-26,"IT","Italy","Europe",25852,1480874,722,52028,"2",-8428,208522,"0","0","0","2","0","0","0","0",-7425.42857142857,208503.285714286,-7577.8,209036.6,-8189,208939.666666667,-4.0417797642455,-3.56130050708348,-3.62510679947913,-3.91931323077316
"180",2020-11-27,"IT","Italy","Europe",29001,1509875,822,52850,"2",-7175,201347,"0","0","0","2","0","0","0","0",-7718.42857142857,200784.857142857,-8382.6,200654,-8166.66666666667,200773,-3.56349982865402,-3.84412882587901,-4.17763912007735,-4.06761201290346
"181",2020-11-28,"IT","Italy","Europe",28342,1538217,827,53677,"2",-8897,192450,"0","0","0","2","0","0","0","0",-8022.14285714286,192762.714285714,-8128,192526,-8173.66666666667,192599.333333333,-4.62301896596519,-4.16166730525094,-4.22176744959122,-4.2438706952949
"182",2020-11-29,"IT","Italy","Europe",26315,1564532,686,54363,"2",-8449,184001,"0","0","0","2","0","0","0","0",-7295.85714285714,185466.857142857,-7752.6,184773.4,-8345.66666666667,184253.666666667,-4.59182287052788,-3.9337794661811,-4.19573380151039,-4.52944400925536
"183",2020-11-30,"IT","Italy","Europe",20646,1585178,541,54904,"2",-7691,176310,"0","0","0","2","0","0","0","0",-6826.57142857143,178640.285714286,-7093.6,177679.8,-7563.66666666667,176690,-4.36220293800692,-3.82140646566684,-3.9923502840503,-4.28075537193201
"184",2020-10-01,"PL","Poland","Europe",1552,91514,30,2513,"0",578,9841,"0","0","0","0","0","0","0","0",644.285714285714,10007.2857142857,657.4,9960.2,674.666666666667,9925.33333333333,5.87338685092978,6.43816647870837,6.60026907090219,6.79742074153681
"185",2020-10-02,"PL","Poland","Europe",1967,93481,30,2543,"0",831,10672,"0","0","0","0","0","0","0","0",388.571428571429,10395.8571428571,702.4,10662.6,704.666666666667,10630,7.78673163418291,3.73775267620343,6.58751148875509,6.62903731577297
"186",2020-10-03,"PL","Poland","Europe",2292,95773,27,2570,"0",705,11377,"0","0","0","0","0","0","0","0",685.142857142857,11081,309.4,10972,773,11403,6.1967126659049,6.1830417574484,2.81990521327014,6.77891782864159
"187",2020-10-04,"PL","Poland","Europe",2367,98140,34,2604,"0",783,12160,"0","0","0","0","0","0","0","0",727.285714285714,11808.2857142857,720.6,11692.6,46,11449,6.43914473684211,6.15911345544291,6.16287224398337,0.401781815005677
"188",2020-10-05,"PL","Poland","Europe",0,98140,0,2604,"0",-1350,10810,"0","0","0","0","0","0","0","0",852,12660.2857142857,736.4,12429,689,12138,-12.4884366327475,6.72970594209113,5.92485316598278,5.67638820233976
"189",2020-10-06,"PL","Poland","Europe",3940,102080,55,2659,"0",2634,13444,"0","0","0","0","0","0","0","0",1063.71428571429,13724,885.6,13314.6,731.333333333333,12869.3333333333,19.59238321928,7.75075987841945,6.65134513992159,5.68276004973063
"190",2020-10-07,"PL","Poland","Europe",2236,104316,58,2717,"0",910,14354,"0","0","0","0","0","0","0","0",1312.57142857143,15036.5714285714,1191.6,14506.2,1665,14534.3333333333,6.33969625191584,8.72919358516379,8.21441866236506,11.4556337866661
"191",2020-10-08,"PL","Poland","Europe",3003,107319,75,2792,"0",1451,15805,"0","0","0","0","0","0","0","0",1619.71428571429,16656.2857142857,1951,16457.2,1558,16092.3333333333,9.18063903827903,9.72434259052782,11.8549935590501,9.68162893303229
"192",2020-10-09,"PL","Poland","Europe",4280,111599,75,2867,"0",2313,18118,"0","0","0","0","0","0","0","0",2409.42857142857,19065.7142857143,2010.8,18468,2070.33333333333,18162.6666666667,12.7663097472127,12.6374943803387,10.8880225254494,11.3988401115842
"193",2020-10-10,"PL","Poland","Europe",4739,116338,52,2919,"0",2447,20565,"0","0","0","0","0","0","0","0",2098,21163.7142857143,2664.4,21132.4,2564.33333333333,20727,11.8988572817894,9.91319374130925,12.6081278037516,12.3719464144996
"194",2020-10-11,"PL","Poland","Europe",5300,121638,53,2972,"0",2933,23498,"0","0","0","0","0","0","0","0",2372.57142857143,23536.2857142857,2465,23597.4,3186,23913,12.481913354328,10.0804836301395,10.4460660920271,13.323296951449
"195",2020-10-12,"PL","Poland","Europe",4178,125816,32,3004,"0",4178,27676,"0","0","0","0","0","0","0","0",2668.57142857143,26204.8571428571,2568.8,26166.2,2521.66666666667,26434.6666666667,15.0961121549357,10.1834992422343,9.81724514832112,9.53924140018158
"196",2020-10-13,"PL","Poland","Europe",4394,130210,35,3039,"0",454,28130,"0","0","0","0","0","0","0","0",2883.71428571429,29088.5714285714,2784,28950.2,2488,28922.6666666667,1.61393530039104,9.91356448286023,9.61651387555181,8.60224967730039
"197",2020-10-14,"PL","Poland","Europe",5068,135278,62,3101,"0",2832,30962,"0","0","0","0","0","0","0","0",2957.85714285714,32046.4285714286,2961.2,31911.4,2269.66666666667,31192.3333333333,9.14669594987404,9.22991195809651,9.27944245630088,7.27636064417538
"198",2020-10-15,"PL","Poland","Europe",6526,141804,116,3217,"0",3523,34485,"0","0","0","0","0","0","0","0",3156.28571428571,35202.7142857143,2718.8,34630.2,3391.33333333333,34583.6666666667,10.2160359576628,8.96602940520009,7.85095090412415,9.80617054293453
"199",2020-10-16,"PL","Poland","Europe",8099,149903,91,3308,"0",3819,38304,"0","0","0","0","0","0","0","0",3182,38384.7142857143,3492.4,38122.6,3436,38019.6666666667,9.97023809523809,8.28975819987867,9.16097013320183,9.03742799779062
"200",2020-10-17,"PL","Poland","Europe",7705,157608,132,3440,"0",2966,41270,"0","0","0","0","0","0","0","0",3558.28571428571,41943,3797.6,41920.2,3702.33333333333,41722,7.18681851223649,8.48362233098661,9.05911708436506,8.87381557291917
"201",2020-10-18,"PL","Poland","Europe",9622,167230,84,3524,"0",4322,45592,"0","0","0","0","0","0","0","0",3757,45700,3710.6,45630.8,3882,45604,9.4797332865415,8.22100656455142,8.13178817816036,8.5124111920007
"202",2020-10-19,"PL","Poland","Europe",8536,175766,49,3573,"0",4358,49950,"0","0","0","0","0","0","0","0",3755.71428571429,49455.7142857143,3791.4,49422.2,3922.66666666667,49526.6666666667,8.72472472472472,7.59409572777954,7.67145129112019,7.9203122896756
"203",2020-10-20,"PL","Poland","Europe",7482,183248,41,3614,"0",3088,53038,"0","0","0","0","0","0","0","0",3782.71428571429,53238.4285714286,3901,53323.2,3889.66666666667,53416.3333333333,5.82224065764169,7.10523279371238,7.31576499534912,7.28179271009491
"204",2020-10-21,"PL","Poland","Europe",9291,192539,107,3721,"0",4223,57261,"0","0","0","0","0","0","0","0",4205.71428571429,57444.1428571429,3838.2,57161.4,3608.33333333333,57024.6666666667,7.37500218298667,7.32139792941715,6.71467108923154,6.32767106632218
"205",2020-10-22,"PL","Poland","Europe",10040,202579,130,3851,"0",3514,60775,"0","0","0","0","0","0","0","0",4160.57142857143,61604.7142857143,4152,61313.4,3915,60939.6666666667,5.78198272315919,6.75365753548546,6.77176604135474,6.42438696196785
"206",2020-10-23,"PL","Poland","Europe",12107,214686,168,4019,"0",4008,64783,"0","0","0","0","0","0","0","0",3996,65600.7142857143,4335.6,65649,4483,65422.6666666667,6.18680826760107,6.09139708844634,6.60421331627291,6.85236513338904
"207",2020-10-24,"PL","Poland","Europe",13632,228318,153,4172,"1",5927,70710,"1","1","1","0","0","0","0","0",3949,69549.7142857143,4132.2,69781.2,4647,70069.6666666667,8.38212416914156,5.67795287235441,5.92165225017627,6.63197103834755
"208",2020-10-25,"PL","Poland","Europe",13628,241946,179,4351,"1",4006,74716,"1","1","1","0","0","0","0","0",4347,73896.7142857143,3981.2,73762.4,4379.66666666667,74449.3333333333,5.36163606188768,5.88253488943061,5.39732980488704,5.8827479986389
"209",2020-10-26,"PL","Poland","Europe",11742,253688,87,4438,"1",3206,77922,"1","1","1","0","0","0","0","0",5099.28571428571,78996,4581.4,78343.8,3323.66666666667,77773,4.11437078103745,6.45511888486216,5.8478143771428,4.27354823224855
"210",2020-10-27,"PL","Poland","Europe",10241,263929,45,4483,"1",2759,80681,"1","1","0","0","0","0","0","0",5676.57142857143,84672.5714285714,5152,83495.8,4324.66666666667,82097.6666666667,3.41964031184542,6.70414436788435,6.17037024616807,5.26770959791793
"211",2020-10-28,"PL","Poland","Europe",16300,280229,132,4615,"1",7009,87690,"1","1","0","0","0","0","0","0",5972.28571428571,90644.8571428571,5960.6,89456.4,6182.66666666667,88280.3333333333,7.99292963849926,6.58866471031372,6.66313421957512,7.00344735142973
"212",2020-10-29,"PL","Poland","Europe",18820,299049,236,4851,"1",8780,96470,"1","0","0","0","0","0","0","0",6581.28571428571,97226.1428571429,6918.8,96375.2,7946,96226.3333333333,9.10127500777444,6.76904947669865,7.1790253094157,8.25761485941132
"213",2020-10-30,"PL","Poland","Europe",20156,319205,298,5149,"1",8049,104519,"1","0","0","0","0","0","0","0",6898.85714285714,104125,8020.8,104396,8275.33333333333,104501.666666667,7.70099216410413,6.62555307837421,7.68305299053604,7.91885296885217
"214",2020-10-31,"PL","Poland","Europe",21629,340834,202,5351,"1",7997,112516,"0","0","0","0","0","0","0","0",7267.14285714286,111392.142857143,7704.8,112100.8,8105,112606.666666667,7.10743360944221,6.52392769431032,6.8730999243538,7.19762003433781
"215",2020-11-01,"PL","Poland","Europe",21897,362731,280,5631,"1",8269,120785,"0","0","0","0","0","0","0","0",6703.57142857143,118095.714285714,7016.2,119117,7231.66666666667,119838.333333333,6.84604876433332,5.67638840165967,5.89017520589001,6.03451872661781
"216",2020-11-02,"PL","Poland","Europe",17171,379902,152,5783,"1",5429,126214,"0","0","0","0","0","0","0","0",6288.14285714286,124383.857142857,6019.2,125136.2,6345,126183.333333333,4.30142456462833,5.05543323835087,4.8101188944526,5.02839783383965
"217",2020-11-03,"PL","Poland","Europe",15578,395480,92,5875,"1",5337,131551,"0","0","0","0","0","0","0","0",6136.42857142857,130520.285714286,5594.2,130730.4,4610,130793.333333333,4.0569817029137,4.70151328419665,4.2791883142712,3.52464447729242
"218",2020-11-04,"PL","Poland","Europe",19364,414844,227,6102,"1",3064,134615,"0","0","0","0","0","0","0","0",5773.57142857143,136293.857142857,5337.8,136068.2,4757.66666666667,135551,2.27612078891654,4.23612006410518,3.92288572936219,3.50987205307719
"219",2020-11-05,"PL","Poland","Europe",24692,439536,373,6475,"1",5872,140487,"0","0","0","0","0","0","0","0",5446.28571428571,141740.142857143,5343.4,141411.6,5307.66666666667,140858.666666667,4.17974616868465,3.84244407018477,3.77861504996761,3.76807958805043
"220",2020-11-06,"PL","Poland","Europe",27143,466679,367,6842,"1",6987,147474,"0","0","0","0","0","0","0","0",5758.42857142857,147498.571428571,5471.6,146883.2,6105.33333333333,146964,4.73778428739981,3.90405718215189,3.72513670726128,4.15430536276458
"221",2020-11-07,"PL","Poland","Europe",27086,493765,445,7287,"1",5457,152931,"0","0","0","1","1","1","1","1",5872.42857142857,153371,6381.6,153264.8,6140.66666666667,153104.666666667,3.56827588912647,3.82890414187074,4.16377406945365,4.01076387830547
"222",2020-11-08,"PL","Poland","Europe",27875,521640,349,7636,"1",5978,158909,"0","0","0","1","1","1","1","0",6304.71428571429,159675.714285714,6434.2,159699,6349.66666666667,159454.333333333,3.76190146561869,3.94844908877815,4.02895447059781,3.98212236314263
"223",2020-11-09,"PL","Poland","Europe",24785,546425,236,7872,"1",7614,166523,"0","0","0","1","1","1","1","0",5541.42857142857,165217.142857143,6254.8,165953.8,6575.66666666667,166030,4.57234135825081,3.3540276000415,3.76900077009385,3.96052922162661
"224",2020-11-10,"PL","Poland","Europe",21713,568138,173,8045,"1",6135,172658,"0","0","0","1","1","1","0","0",3906.14285714286,169123.285714286,5269.2,171223,6613,172643,3.55326715240533,2.309642247456,3.07739030387273,3.8304478026911
"225",2020-11-11,"PL","Poland","Europe",25454,593592,330,8375,"1",6090,178748,"0","0","0","1","1","1","0","0",2693,171816.285714286,3181.6,174404.6,4251.33333333333,176894.333333333,3.40703112762101,1.56737179412562,1.82426380955548,2.40331798832825
"226",2020-11-12,"PL","Poland","Europe",25221,618813,430,8805,"1",529,179277,"0","0","0","1","1","0","0","0",1509.85714285714,173326.142857143,1051.8,175456.4,719.666666666667,177614,0.295074103203423,0.871107565176467,0.599465166274926,0.405185777397427
"227",2020-11-13,"PL","Poland","Europe",22683,641496,275,9080,"1",-4460,174817,"0","0","0","1","1","0","0","0",3.42857142857143,173329.571428571,-636,174820.4,-2322,175292,-2.55123929594948,0.00197806490855159,-0.36380193615848,-1.32464687492869
"228",2020-11-14,"PL","Poland","Europe",24051,665547,419,9499,"1",-3035,171782,"0","0","0","1","0","0","0","0",-1001.14285714286,172328.428571429,-2440.2,172380.2,-3266.33333333333,172025.666666667,-1.7667741672585,-0.580950494031745,-1.41559181390902,-1.89874766749923
"229",2020-11-15,"PL","Poland","Europe",25571,691118,546,10045,"1",-2304,169478,"0","0","0","1","0","0","0","0",-2771.42857142857,169557,-2725.4,169654.8,-2756.66666666667,169269,-1.35946848558515,-1.63451144537151,-1.60643848567798,-1.62857148483577
"230",2020-11-16,"PL","Poland","Europe",21854,712972,303,10348,"1",-2931,166547,"0","0","0","1","0","0","0","0",-3609.57142857143,165947.428571429,-3093.8,166561,-2044,167225,-1.75986358205191,-2.17512947301727,-1.85745762813624,-1.22230527732097
"231",2020-11-17,"PL","Poland","Europe",20816,733788,143,10491,"1",-897,165650,"0","0","0","1","0","0","0","0",-2787.85714285714,163159.571428571,-3554.4,163006.6,-3376.66666666667,163848.333333333,-0.541503169332931,-1.70866907681087,-2.18052520572787,-2.06084895584331
"232",2020-11-18,"PL","Poland","Europe",19152,752940,357,10848,"1",-6302,159348,"0","0","0","1","0","0","0","0",-2581,160578.571428571,-2835.2,160171.4,-4179,159669.333333333,-3.95486607927304,-1.60731284195543,-1.77010377632961,-2.617284053711
"233",2020-11-19,"PL","Poland","Europe",19883,772823,603,11451,"1",-5338,154010,"0","0","0","1","0","0","0","0",-2445.85714285714,158132.714285714,-2566.4,157605,-3449.33333333333,156220,-3.46600870073372,-1.54671166804736,-1.62837473430411,-2.20799726880895
"234",2020-11-20,"PL","Poland","Europe",23975,796798,637,12088,"1",1292,155302,"0","0","0","1","0","0","0","0",-2598.28571428571,155534.428571429,-2658.6,154946.4,-1877.66666666667,154342.333333333,0.831927470348096,-1.67055341904089,-1.71581914778272,-1.21655972545877
"235",2020-11-21,"PL","Poland","Europe",22464,819262,626,12714,"1",-1587,153715,"0","0","0","1","0","0","0","0",-3300.71428571429,152233.714285714,-2197.8,152748.6,-551,153791.333333333,-1.03243014670006,-2.16818876239166,-1.4388347912845,-0.358277666275083
"236",2020-11-22,"PL","Poland","Europe",24213,843475,574,13288,"1",-1358,152357,"0","0","0","1","0","0","0","0",-460.285714285714,151773.428571429,-2293,150455.6,-2314.33333333333,151477,-0.891327605557999,-0.303271605984108,-1.52403765629196,-1.5278447112983
"237",2020-11-23,"PL","Poland","Europe",17856,861331,330,13618,"1",-3998,148359,"0","0","0","1","0","0","0","0",-344.428571428571,151429,164.8,150620.4,-3723.33333333333,147753.666666667,-2.69481460511327,-0.227452186456076,0.109414129825708,-2.51996002355272
"238",2020-11-24,"PL","Poland","Europe",15002,876333,156,13774,"1",-5814,142545,"0","0","0","1","0","0","0","0",-1569.71428571429,149859.285714286,-423.2,150197.2,1256.33333333333,149010,-4.07871198568873,-1.04745880659476,-0.28176290902893,0.843120148535892
"239",2020-11-25,"PL","Poland","Europe",32733,909066,540,14314,"1",13581,156126,"0","0","0","1","0","0","0","0",-2080.14285714286,147779.142857143,-1608.6,148588.6,1080,150090,8.6987433227009,-1.40760246468185,-1.08258641645456,0.719568259044573
"240",2020-11-26,"PL","Poland","Europe",15356,924422,674,14988,"1",-4527,151599,"0","0","0","1","0","0","0","0",-3177,144602.142857143,-1841,146747.6,589.666666666667,150679.666666667,-2.98616745493044,-2.19706287695796,-1.25453499750592,0.391337915533837
"241",2020-11-27,"PL","Poland","Europe",16690,941112,580,15568,"1",-7285,144314,"0","0","0","1","0","0","0","0",-3516.42857142857,141085.714285714,-2485.4,144262.2,-5657.33333333333,145022.333333333,-5.04802028909184,-2.49240583232078,-1.72283522641413,-3.90100835043798
"242",2020-11-28,"PL","Poland","Europe",17304,958416,579,16147,"1",-5160,139154,"0","0","0","1","0","0","0","0",-4009.57142857143,137076.142857143,-6476.4,137785.8,-7160.33333333333,137862,-3.70812193684695,-2.92506875740595,-4.700339222184,-5.19384118417935
"243",2020-11-29,"PL","Poland","Europe",15177,973593,599,16746,"1",-9036,130118,"0","0","0","1","0","0","0","0",-9324,127752.142857143,-7424.2,130361.6,-6856.66666666667,131005.333333333,-6.94446579258827,-7.29850771303808,-5.69508198733369,-5.23388360779205
"244",2020-11-30,"PL","Poland","Europe",11482,985075,283,17029,"1",-6374,123744,"0","0","0","1","0","0","0","0",-8896.28571428571,118855.857142857,-10691.2,119670.4,-8225.33333333333,122780,-5.15095681406775,-7.4849367360945,-8.93387170093858,-6.69924526252919
"245",2020-10-01,"GB","UK","Europe",7108,453268,71,42143,"1",930,43535,"0","0","0","1","0","0","0","0",1688.71428571429,43672.1428571429,639.6,42850.6,1142.33333333333,43318.3333333333,2.13621224302286,3.86679969251403,1.49262787452218,2.63706667692663
"246",2020-10-02,"GB","UK","Europe",6914,460182,59,42202,"1",280,43815,"0","0","0","1","0","0","0","0",3899.57142857143,47571.7142857143,2070.4,44921,435,43753.3333333333,0.639050553463426,8.19724806457619,4.60898020970148,0.994209964955051
"247",2020-10-03,"GB","UK","Europe",6968,467150,66,42268,"1",95,43910,"0","0","0","1","0","0","0","0",5167.14285714286,52738.8571428571,5080.8,50001.8,2401.66666666667,46155,0.216351628330676,9.79760111817798,10.161234195569,5.20348102408551
"248",2020-10-04,"GB","UK","Europe",12871,480021,49,42317,"1",6830,50740,"0","0","0","1","0","0","0","0",5907.42857142857,58646.2857142857,6604.6,56606.4,8064.66666666667,54219.6666666667,13.4607804493496,10.072979898861,11.6675852907092,14.8740616873336
"249",2020-10-05,"GB","UK","Europe",22961,502982,33,42350,"1",17269,68009,"0","0","0","1","0","0","0","0",6782.28571428571,65428.5714285714,8028.4,64634.8,10882.6666666667,65102.3333333333,25.3922274993016,10.3659388646288,12.4211724953121,16.7162467295079
"250",2020-10-06,"GB","UK","Europe",12593,515575,19,42369,"1",8549,76558,"0","0","0","1","0","0","0","0",8260.28571428571,73688.8571428571,9420.2,74055,11072.3333333333,76174.6666666667,11.1666971446485,11.2096808589009,12.7205455404767,14.5354536066234
"251",2020-10-07,"GB","UK","Europe",14542,530117,76,42445,"1",7399,83957,"0","0","0","1","0","0","0","0",9231.85714285714,82920.7142857143,10179.4,84234.4,7667.33333333333,83842,8.81284467048608,11.1333545813988,12.0846115126362,9.14497904789167
"252",2020-10-08,"GB","UK","Europe",14162,544279,70,42515,"1",7054,91011,"0","0","0","1","0","0","0","0",8583.85714285714,91504.5714285714,8104.8,92339.2,8359.66666666667,92201.6666666667,7.75071145246179,9.38079596335546,8.77720404768506,9.06671969053343
"253",2020-10-09,"GB","UK","Europe",17540,561819,77,42592,"1",10626,101637,"0","0","0","1","0","0","0","0",4675.57142857143,96180.1428571429,6853.8,99193,8192,100393.666666667,10.4548540393754,4.86126479923833,6.90956015041384,8.15987728309555
"254",2020-10-10,"GB","UK","Europe",13864,575683,87,42679,"1",6896,108533,"0","0","0","1","0","0","0","0",3651.28571428571,99831.4285714286,3356.2,102549.2,6605.33333333333,106999,6.35382786802171,3.65745113190807,3.27277053355853,6.17326641682009
"255",2020-10-11,"GB","UK","Europe",15165,590848,81,42760,"1",2294,110827,"0","0","0","1","0","0","0","0",2978.57142857143,102810,2221.2,104770.4,-299.666666666667,106699.333333333,2.06989271567398,2.89716119888282,2.12006444568313,-0.280851489231423
"256",2020-10-12,"GB","UK","Europe",12872,603720,65,42825,"1",-10089,100738,"0","0","0","1","0","0","0","0",2765.42857142857,105575.428571429,634,105404.4,-2138.66666666667,104560.666666667,-10.015088645794,2.61938654557067,0.601492916804232,-2.04538354129341
"257",2020-10-13,"GB","UK","Europe",13972,617692,50,42875,"1",1379,102117,"0","0","0","1","0","0","0","0",1452.85714285714,107028.285714286,367.2,105771.6,-2006.66666666667,102554,1.35041178256314,1.35745156821027,0.347163132636738,-1.95669273423432
"258",2020-10-14,"GB","UK","Europe",17232,634924,143,43018,"1",2690,104807,"0","0","0","1","0","0","0","0",720.714285714286,107749,196,105967.6,3210.33333333333,105764.333333333,2.56662245842358,0.668882574979151,0.184962195991982,3.03536478901205
"259",2020-10-15,"GB","UK","Europe",19724,654648,137,43155,"1",5562,110369,"0","0","0","1","0","0","0","0",536.714285714286,108285.714285714,2568,108535.6,3230,108994.333333333,5.03945854361279,0.495646437994723,2.36604395239903,2.96345681579776
"260",2020-10-16,"GB","UK","Europe",18978,673626,138,43293,"1",1438,111807,"0","0","0","1","0","0","0","0",2565,110850.714285714,2493.4,111029,2923.66666666667,111918,1.28614487465007,2.31392284346386,2.24571958677463,2.61232926487845
"261",2020-10-17,"GB","UK","Europe",15635,689261,136,43429,"1",1771,113578,"0","0","0","1","0","0","0","0",3058.14285714286,113908.857142857,2777.2,113806.2,1405,113323,1.55928084664284,2.68472789021799,2.44028884190844,1.23981892466666
"262",2020-10-18,"GB","UK","Europe",16171,705432,150,43579,"1",1006,114584,"0","0","0","1","0","0","0","0",3259.28571428571,117168.142857143,2631,116437.2,2295.33333333333,115618.333333333,0.87795852824129,2.78171662945925,2.25958714225351,1.98526761903389
"263",2020-10-19,"GB","UK","Europe",16981,722413,67,43646,"1",4109,118693,"0","0","0","1","0","0","0","0",3459.42857142857,120627.571428571,3163,119600.2,3315.33333333333,118933.666666667,3.46187222498378,2.86785892351074,2.64464440694915,2.78754824117645
"264",2020-10-20,"GB","UK","Europe",18803,741216,80,43726,"1",4831,123524,"0","0","0","1","0","0","0","0",3576.85714285714,124204.428571429,4201.4,123801.6,4346,123279.666666667,3.91098086201872,2.87981449936798,3.39365565550041,3.52531777340951
"265",2020-10-21,"GB","UK","Europe",21330,762546,241,43967,"1",4098,127622,"0","0","0","1","0","0","0","0",4023.28571428571,128227.714285714,4452.2,128253.8,5297.33333333333,128577,3.21104511761295,3.13761009988926,3.47139811841832,4.11996961613145
"266",2020-10-22,"GB","UK","Europe",26687,789233,191,44158,"1",6963,134585,"0","0","0","1","0","0","0","0",4856.85714285714,133084.571428571,4609.6,132863.4,4440.33333333333,133017.333333333,5.1736820596649,3.64945169129834,3.46942799898241,3.33816144261901
"267",2020-10-23,"GB","UK","Europe",21238,810471,189,44347,"2",2260,136845,"1","1","1","1","0","0","0","0",4671.14285714286,137755.714285714,5011.6,137875,4706.33333333333,137723.666666667,1.65150352588695,3.39088863308756,3.63488667271079,3.41722918597869
"268",2020-10-24,"GB","UK","Europe",20531,831002,224,44571,"2",4896,141741,"1","1","1","1","0","0","0","0",4279.14285714286,142034.857142857,4753.8,142628.8,4665.66666666667,142389.333333333,3.4541875674646,3.01274133914814,3.3329874471355,3.27669675631133
"269",2020-10-25,"GB","UK","Europe",23012,854014,174,44745,"2",6841,148582,"1","1","1","1","0","0","0","0",3915.85714285714,145950.714285714,3778.6,146407.4,4848.66666666667,147238,4.6041916248267,2.68299964273654,2.58088047462082,3.29308104339007
"270",2020-10-26,"GB","UK","Europe",19790,873804,151,44896,"2",2809,151391,"1","1","0","1","0","0","0","0",2637.28571428571,148588,3637.6,150045,3912.33333333333,151150.333333333,1.85546036422244,1.77489818443327,2.42433936485721,2.58837228278248
"271",2020-10-27,"GB","UK","Europe",20890,894694,102,44998,"2",2087,153478,"1","1","0","1","0","0","0","0",2575.42857142857,151163.428571429,2261,152306,2150.33333333333,153300.666666667,1.35980401099832,1.70373786554571,1.48451144406655,1.40269013833382
"272",2020-10-28,"GB","UK","Europe",22885,917579,367,45365,"2",1555,155033,"1","0","0","1","0","0","0","0",2429.42857142857,153592.857142857,1258.2,153564.2,551.666666666667,153852.333333333,1.00301226190553,1.58173278147235,0.819331589003166,0.358568930814612
"273",2020-10-29,"GB","UK","Europe",24700,942279,310,45675,"2",-1987,153046,"1","0","0","1","0","0","0","0",1295.42857142857,154888.285714286,1471.2,155035.4,465,154317.333333333,-1.29830247115246,0.836363166817005,0.948944563628694,0.301327135426567
"274",2020-10-30,"GB","UK","Europe",23065,965344,280,45955,"2",1827,154873,"0","0","0","1","0","0","0","0",1389,156277.285714286,834.4,155869.8,1238,155555.333333333,1.17967625086361,0.888804789289368,0.535318579994329,0.795858279797543
"275",2020-10-31,"GB","UK","Europe",24405,989749,274,46229,"2",3874,158747,"0","0","0","1","0","0","0","0",813.714285714286,157091,1216.2,157086,1534.66666666667,157090,2.44036107768966,0.517989118227197,0.774225583438371,0.976934665902773
"276",2020-11-01,"GB","UK","Europe",21915,1011664,326,46555,"2",-1097,157650,"0","0","0","1","0","0","0","0",182,157273,1225.6,158311.6,2080.33333333333,159170.333333333,-0.695845226768157,0.115722342678018,0.774169422834461,1.30698559823753
"277",2020-11-02,"GB","UK","Europe",23254,1034918,162,46717,"2",3464,161114,"0","0","0","1","0","0","0","0",534,157807,286.8,158598.4,142.333333333333,159312.666666667,2.15003041324776,0.338388030949197,0.180834106775352,0.0893421322430943
"278",2020-11-03,"GB","UK","Europe",18950,1053868,136,46853,"2",-1940,159174,"0","0","0","1","0","0","0","0",426.285714285714,158233.285714286,-392.6,158205.8,-447.666666666667,158865,-1.21879201377109,0.269403313191283,-0.248157779297598,-0.281790618869271
"279",2020-11-04,"GB","UK","Europe",20018,1073886,397,47250,"2",-2867,156307,"0","0","0","1","0","0","0","0",-286.857142857143,157946.428571429,41.4,158247.2,-1443.33333333333,157421.666666667,-1.83421087987102,-0.181616732617298,0.026161600331633,-0.91685811991149
"280",2020-11-05,"GB","UK","Europe",25177,1099063,492,47742,"2",477,156784,"0","0","0","1","0","0","0","0",304.428571428571,158250.857142857,-875,157372.2,-439,156982.666666667,0.304240228594755,0.192370883118665,-0.556006715290248,-0.279648708562304
"281",2020-11-06,"GB","UK","Europe",24138,1123201,378,48120,"1",1073,157857,"-1","-1","-1","2","1","1","1","1",-573.571428571429,157677.285714286,121.4,157493.6,144,157126.666666667,0.679729121926807,-0.363762875529676,0.077082497320526,0.0916458059315202
"282",2020-11-07,"GB","UK","Europe",23287,1146488,355,48475,"1",-1118,156739,"-1","-1","-1","2","1","1","1","0",46.4285714285714,157723.714285714,158.4,157652,999,158125.666666667,-0.713287694830259,0.0294366459976125,0.10047446274072,0.631775992512285
"283",2020-11-08,"GB","UK","Europe",24957,1171445,413,48888,"1",3042,159781,"-1","-1","-1","2","1","1","1","0",512.285714285714,158236,543,158195,-252.666666666667,157873,1.90385590276691,0.323747891937179,0.343247258130788,-0.160044254981325
"284",2020-11-09,"GB","UK","Europe",20572,1192017,156,49044,"1",-2682,157099,"-1","-1","0","2","1","1","0","0",126,158362,407.2,158602.2,920,158793,-1.70720373777045,0.0795645419987118,0.256742970778463,0.579370627168704
"285",2020-11-10,"GB","UK","Europe",21350,1213367,194,49238,"1",2400,159499,"-1","-1","0","2","1","1","0","0",1305.85714285714,159667.857142857,185.4,158787.6,37.3333333333333,158830.333333333,1.50471162828607,0.817858500905899,0.116759746982762,0.0235051658898069
"286",2020-11-11,"GB","UK","Europe",20412,1233779,532,49770,"1",394,159893,"-1","0","0","2","1","0","0","0",2039,161706.857142857,1443.4,160231,189,159019.333333333,0.246414789890739,1.26092364666928,0.90082443472237,0.118853472743356
"287",2020-11-12,"GB","UK","Europe",22950,1256729,595,50365,"1",-2227,157666,"-1","0","0","2","1","0","0","0",1876.28571428571,163583.142857143,2782.6,163013.6,2499.66666666667,161519,-1.41247954536806,1.14699209314267,1.70697414203478,1.54759914726234
"288",2020-11-13,"GB","UK","Europe",33470,1290199,563,50928,"1",9332,166998,"0","0","0","2","0","0","0","0",2886.57142857143,166469.714285714,2683.2,165696.8,3706.33333333333,165225.333333333,5.58809087533982,1.73399194018989,1.61934328242911,2.24319918656542
"289",2020-11-14,"GB","UK","Europe",27301,1317500,376,51304,"1",4014,171012,"0","0","0","2","0","0","0","0",2545.57142857143,169015.285714286,3482.4,169179.2,5083,170308.333333333,2.34720370500316,1.50611905770146,2.05840907156435,2.98458677888144
"290",2020-11-15,"GB","UK","Europe",26860,1344360,462,51766,"1",1903,172915,"0","0","0","2","0","0","0","0",2437.71428571429,171453,3930.4,173109.6,3435.66666666667,173744,1.1005407281034,1.42179739387137,2.2704691132092,1.97743039567793
"291",2020-11-16,"GB","UK","Europe",24962,1369322,168,51934,"1",4390,177305,"0","0","0","2","0","0","0","0",2278.57142857143,173731.571428571,1991.8,175101.4,2102,175846,2.4759595048081,1.31154712401151,1.13751232143204,1.19536412542793
"292",2020-11-17,"GB","UK","Europe",21363,1390685,213,52147,"1",13,177318,"0","0","0","2","0","0","0","0",-562.428571428571,173169.142857143,520.8,175622.2,1347.33333333333,177193.333333333,0.00733146099098794,-0.324785676101978,0.296545653112192,0.760374731931224
"293",2020-11-18,"GB","UK","Europe",20051,1410736,598,52745,"1",-361,176957,"0","0","0","2","0","0","0","0",-2142.85714285714,171026.285714286,-1970.8,173651.4,-1229.66666666667,175963.666666667,-0.204004362641772,-1.2529402330803,-1.13491742652233,-0.698818506093114
"294",2020-11-19,"GB","UK","Europe",19609,1430345,529,53274,"1",-3341,173616,"0","0","0","2","0","0","0","0",-3412.57142857143,167613.714285714,-4258.6,169392.8,-4752.33333333333,171211.333333333,-1.92436180997143,-2.03597387189592,-2.51403837707388,-2.7757118882317
"295",2020-11-20,"GB","UK","Europe",22915,1453260,501,53775,"1",-10555,163061,"0","0","0","1","-1","-1","-1","-1",-4939.71428571429,162674,-5658.2,163734.6,-6981.66666666667,164229.666666667,-6.47303769754877,-3.03657270720231,-3.45571430839908,-4.25116046836848
"296",2020-11-21,"GB","UK","Europe",20252,1473512,511,54286,"1",-7049,156012,"0","0","0","1","-1","-1","-1","0",-5786.28571428571,156887.714285714,-6846,156888.6,-8196.33333333333,156033.333333333,-4.51824218649847,-3.68817006521498,-4.36360576867918,-5.25293740653706
"297",2020-11-22,"GB","UK","Europe",19875,1493387,340,54626,"1",-6985,149027,"0","0","0","1","-1","-1","-1","0",-6985,149902.714285714,-7360.4,149528.2,-6778,149255.333333333,-4.6870701282318,-4.65968880769337,-4.92241597237177,-4.54121125766583
"298",2020-11-23,"GB","UK","Europe",18662,1512049,125,54751,"1",-6300,142727,"0","0","0","1","-1","-1","0","0",-6707.14285714286,143195.571428571,-6999.8,142528.4,-6399.33333333333,142856,-4.41402117328887,-4.68390383182241,-4.91116156499336,-4.47956916988669
"299",2020-11-24,"GB","UK","Europe",15450,1527499,479,55230,"1",-5913,136814,"0","0","0","1","-1","-1","0","0",-5965,137230.571428571,-5869.2,136659.2,-6988.33333333333,135867.666666667,-4.32192611867207,-4.34669909037345,-4.29477122652555,-5.1434852049666
"300",2020-11-25,"GB","UK","Europe",11299,1538798,608,55838,"1",-8752,128062,"0","0","0","1","-1","0","0","0",-5745.57142857143,131485,-5544.2,131115,-5353.66666666667,130514,-6.83418968936921,-4.36975429027754,-4.22850169698356,-4.10198650464063
"301",2020-11-26,"GB","UK","Europe",18213,1557011,695,56533,"1",-1396,126666,"0","0","0","1","-1","0","0","0",-5319.71428571429,126165.285714286,-5386.8,125728.2,-5169.33333333333,125344.666666667,-1.10211106374244,-4.21646434325947,-4.2844803313815,-4.12409516160773
"302",2020-11-27,"GB","UK","Europe",17555,1574566,498,57031,"1",-5360,121306,"0","0","0","1","0","0","0","0",-5349.28571428571,120816,-5005,120723.2,-4089.66666666667,121255,-4.418577811485,-4.42763020981138,-4.14584769124742,-3.37278187841051
"303",2020-11-28,"GB","UK","Europe",14739,1589305,520,57551,"1",-5513,115793,"0","0","0","1","0","0","0","0",-4950.28571428571,115865.714285714,-4556,116167.2,-4959,116296,-4.76108227613068,-4.27243360540527,-3.92193321350605,-4.2641191442526
"304",2020-11-29,"GB","UK","Europe",15871,1605176,479,58030,"1",-4004,111789,"0","0","0","1","0","0","0","0",-3395.71428571429,112470,-4900.8,111266.4,-5341.33333333333,110954.666666667,-3.58174775693494,-3.01921782316554,-4.40456418110049,-4.81397808113824
"305",2020-11-30,"GB","UK","Europe",12155,1617331,215,58245,"1",-6507,105282,"0","0","0","1","0","0","0","0",-3488.14285714286,108981.857142857,-3402.8,107863.6,-4543.66666666667,106411,-6.1805436826808,-3.2006638064265,-3.15472504162665,-4.26992196921997
